Cancel=Cancelar

; My PSAs / banners
Happy New Year=Feliz Año Nuevo
Happy Holidays from Andrew, Tracey, and family=Felices Fiestas de parte de Andrew, Tracey y familia
Please Enjoy Responsibly=Por favor, disfrute responsablemente
Popup Blocked CA requires popups to be enabled under certain circumstances You must white list your server within your browser to allow popups=Ventana emergente bloqueada. Community Applications (CA) requiere que las ventanas emergentes estén habilitadas bajo ciertas circunstancias. Debe incluir su servidor a la lista de excepciones del navegador para que permita las ventanas emergentes.
Docker Service Not Enabled - Only Plugins Available To Be Installed Or Managed=Servicio Docker deshabilitado. Únicamente se pueden instalar o administrar plugins.
Docker system failed to start - Only Plugins Available To Be Installed Or Managed=El sistema Docker no se pudo iniciar. Solo los plugin están disponibles para ser utilizados
Array not started - Only Plugins Available To Be Installed Or Managed=Array no iniciado. Sólo los pugins están disponibles para ser utilizados
Community Applications works best when cookies are enabled in your browser Certain features may not be available=Community Applications (CA) requiere que las cookies están habilitadas en su navegador. De lo contrario algunas funciones podrían no estar disponibles.
Backup Server Active Some icons may not appear, and plugin installations may be affected=Servidor de reserva de CA activo. No se ha podido obtener la lista de aplicaciones del servidor principal. Puede que algunos iconos no aparezcan y se vea afectada la instalación de plugins.
Debugging enabled This significantly increases the memory used by your browser=Depuración habilitada. Esto aumenta significativamente la memoria utilizada por su navegador
Browser translation detected Display issues may result=Traducción del navegador detectada. Se pueden producir problemas de visualización
Action Centre Enabled=Centro de Acción Habilitado
Deprecated OS version No further updates to Community Applications will be issued for this OS version=Versión obsoleta del sistema operativo. No se publicarán más actualizaciones de Comunity Applications (CA) para esta versión del sistema operativo

; Sorting Options
Sort By=Ordenar por
Name Ascending=Nombre ascendente
Name Descending=Nombre descendente
Downloads=Descargas
Date Added=Añadido
Number Of Apps=Número de aplicaciones
; Initial disclaimer translations
Disclaimer=Descargo de responsabilidad
All applications listed here are 3rd party additions to Unraid Neither the authors of Community Applications nor Limetech make any warranty as to the suitability of any application listed here=Todas las aplicaciones mostradas aquí son programas de terceros ajenos a Unraid. Ni los autores del plugin Community Applications (CA) ni Limetech garantizan la idoneidad de las aplicaciones de este listado.
Every attempt is made to ensure that only safe and compatible applications are present=Se hace todo lo posible para asegurar que solo las aplicaciones seguras y compatibles estén disponibles.
Application Policy=Política de CA
I Understand=Entendido
Installations of apps disabled You must accept the warning to be able to install applications=La instalacion de aplicaciones está deshabilitada. Debe aceptar el aviso para poder instalar aplicaciones.
Click here=haga clic aquí
%s Results Per Page=%s resultados por página
Results Per Page: %s=Resultados por pág: %s

; Plugin Disclaimer
Community Applications contains both docker containers and plugin applications Plugins are designed for OS enhancements, and run with full privileges on your system and are clearly identified within CA=Community Applications (CA) tiene dos tipos de aplicaciones: contenedores Docker y plugins. Los plugins añaden funciones adicionales al sistema operativo, se ejecutan con derechos de administrador en el sistema y están claramente identificados en CA.
Plugin Note=Nota del Plugin

; Multi Install
Install Plugin Applications=Instalar Plugins
Select all on page=Seleccionar toda la página
Install Application=Instalar la Aplicación
Install Applications=Instalar las Aplicaciones
Update Application=Actualizar la Aplicación
Update Applications=Actualizar las Aplicaciones
Are you sure you want to update %s applications=¿Estás seguro de que quieres actualizar %s aplicaciones
Are you sure you want to install %s docker and %s plugin applications=¿Estás seguro de que quieres instalar %s Docker(s) y %s Plugin(s)

; Searches
Search=Buscar
Click Here To Get More Results From DockerHub=Pulse aquí para obtener más resultados de DockerHub
No Matching Applications Found=No se encontró ninguna aplicación

; Repository Related
%s removed as favourite repository=%s eliminado como repositorio favorito
%s set as favourite repository=%s añadido como repositorio favorito
Click to remove favourite repository=Click para eliminarlo de como repositorio favorito
Click to set %s as favourite repository=Click para añadir a %s como repositorio favorito
Search for apps in repository=Buscar aplicaciones en el repositorio
No description present=Sin descripción
Go to the forum page=Ir a la página del Foro
Go to the webpage=Ir a la página Web
Go to reddit=Ir a Reddit
Go to facebook=Ir a Facebook
Go to discord=Ir a Discord
Go to forum profile=Ir al Foro
Show Profile=Mostrar perfil
SHOW MORE=Mostrar más
SHOW LESS=Mostrar menos
Read more=Leer más
Total Applications=Aplicaciones totales
Total Known Downloads=Descargas totales conocidas
Total Docker Applications=Total de Dockers
Total Plugin Applications=Total de Plugins
Total Languages=Total lenguajes
Average Downloads Per App=Promedio de descargas
Web Page=Página web
Forum=Foro
Forum Profile=Perfil en el foro
Profile=Perfil
Facebook=Facebook
Reddit=Reddit
Twitter=Twitter
Discord=Discord
Search Apps=Buscar aplicaciones
Registry=Registro
Details=Detalles
Added=Añadido
; Install Plugin title of openbox
Install Plugin=Instalar plugin
Update Plugin=Actualizar Plugin

Requirements not met=Requerimientos no cumplidos
The requirements for this upgrade have not been met on your system=Los requisitos para esta actualización no se han cumplido en este sistema
The sidebar for the app click info will list the details=En la barra lateral de la aplicación (haga clic en información) aparecerán los detalles

BACK=Atrás

; Remove App from previously installed
Delete Template=Eliminar Plantilla
Yes, delete it=Sí, eliminar

; Uninstall popup
Uninstall Application=Desinstalar la Aplicación
Yes uninstall it=Sí, desinstalar

; Remove Private Application
Remove Private Application=Eliminar la Aplicación Privada
Yes, remove it=Sí, eliminar

; App Pinning
Click to pin this application=Haga clic para anclar esta aplicación
Click to unpin this application=Haga clic para desanclar esta aplicación
Pin App=Anclar App
Unpin App=Desanclar App

; Branch installations
Choose A Branch To Install=Elija la Rama a Instalar

; Multiple application installs
; no apps selected
Install Selected Applications=Instalar las Aplicaciones Seleccionadas

Yes, install it=Sí, instalar

; Multi-install popup
Yes, install them=Sí, instalarlas
Cookies not enabled Plugins must be separately installed from docker applications=Las cookies no están habilitadas. Los plugins deben de ser instalados por separado de las aplicaciones Docker.
Docker applications will be installed utilizing the most recently saved template with no user input on your part=Las aplicaciones Docker serán instalados utilizando la última versión guardada de la plantilla sin ninguna interacción por su parte.
Updating Support Links=Actualizando Los Enlaces De Soporte
Downloading docker icons=Descargando iconos de docker
Finished Installing If the DONE button did not appear, then you will need to click the red X in the top right corner=Instalación Finalizada. Si el botón HECHO no aparece, haga clic en la X roja de la esquina superior derecha.

; error messages
An error occurred Could not find any %s Apps=A ocurrido un error. No se pudieron encontrar las Apps %s
Download of appfeed failed=La descarga de la lista de aplicaciones ha fallado
; the %s here refers to a function being called
Something really went wrong here=Ha sucedido un problema aquí
Post the ENTIRE contents of this message in the Community Applications Support Thread=Publique el contenido COMPLETO de este mensaje en el sitio de soporte de Community Applications (CA).
Unknown error happened Please post a screenshot in the support thread of the Statistics screen=Ha ocurrido un error desconocido. Por favor, publique una captura de pantalla de la página de Estadísticas en el sitio de soporte de Community Applications (CA).
This plugin has a duplicated name from another plugin %s This will impact your ability to install both plugins simultaneously=Este plugin tiene el mismo nombre que el plugin %s . Debido a esto no podrá instalar ambos plugins a la vez.
You have been logged out=Su sesión ha sido cerrada
Fatal Flash Drive Error=Error fatal de la unidad de memoria Flash
This usually means your flash drive is corrupted or has dropped offline The rest of the Unraid GUI will also be affected Post a new thread in the Unraid forums if this error continues=Esto generalmente significa que su unidad Flash está dañada o se ha desconectado. El resto de la GUI de Unraid también se verá afectada. Publique un nuevo hilo en los foros de Unraid si este error continúa.
Fatal Docker Image Error=Error fatal de imagen de Docker
Your docker image or folder is either read-only or completely full Issues will result because of this You should create a new post in the Unraid forums and include your diagnostics=La imagen docker es de solo lectura o está completamente llena lo que producirán problemas. Debe crear una nueva publicación en los foros de Unraid e incluir sus diagnósticos.
This template is set up to use a custom network You may have to adjust the network or IP address etc to match your system=Esta plantilla está configurada para usar una red personalizada. Es posible que deba ajustar la red o la dirección IP para que coincida con su sistema
This template is set up to run as Privileged This is a possible security risk and usually does not need to be enabled Note that some applications require privileged in order to operate correctly=Esta plantilla está configurada para ejecutarse como Privilegiada. Este es un posible riesgo de seguridad y normalmente no es necesario habilitarla. Tenga en cuenta que algunas aplicaciones requieren privilegios para funcionar correctamente
One or more ports used by this application are already in use by another service or app running on your server You will need to adjust the host ports accordingly on the template=Uno o varios puertos utilizados por esta aplicación ya están en uso por otro servicio o aplicación. Deberá ajustar los puertos de host según corresponda en la plantilla
Not Enough Memory=Memoria insuficiente
Community Applications and Unraid OS have a minimum required installed memory of 4G CA cannot run without those mimimums being met=Aplicaciones comunitarias y el sistema operativo Unraid requieren una memoria instalada mínima requerida de 4G. CA no puede ejecutarse sin que se cumplan esos mínimos
Run Anyways=Ejecutar de todos modos
Memory Requirements not met Problems may result=No se cumplen los requisitos de memoria. Pueden surgir problemas.
Installation already in progress=La instalación ya está en progreso
Another plugin installation or update is already in progress and this one cannot start Wait until the current installation or update is completed and try again=Ya se está realizando otra instalación o actualización de plugins y ésta no puede iniciarse. Espere hasta que se complete la instalación o actualización actual y vuelva a intentarlo.
Clear Flag=Eliminar Marca
%s is incompatible with your OS version Please update the OS to proceed=%s es incompatible con la versión de su sistema operativo. Actualice el sistema operativo para continuar.
%s is incompatible with your OS version Either uninstall %s or update the OS=%s es incompatible con la versión de su sistema operativo. Desinstale %s o actualice el sistema operativo
Browser failed to communicate with Unraid Server=El navegador no pudo comunicarse con el servidor Unraid
For unknown reasons, your browser was unable to communicate with Community Applications running on your server=Por razones desconocidas, su navegador no pudo comunicarse con Community Applications
Additional information may be within Tools, PHPSettings - View Log=Puede encontrar información adicional en Herramientas, Configuración PHP - Ver Registro
Attempt to Fix Via Reload Page=Intente solucionarlo recargando la página
External Link=Enlace externo
Clicking OK will take you to a 3rd party website not associated with Limetech=Al hacer clic en aceptar, accederá a un sitio web de terceros que no está asociado con Limetech

; CA Sections Keep the length reasonable
Home=Inicio
Installed Apps=Apps Instaladas
Previous Apps=Apps Instaladas Previamente
Pinned Apps=Apps Ancladas
Favourite Repo=Repos favoritos
Action Centre=Centro de Acción
Recently Added=Añadido recientemente
Random Apps=Aplicaciones aleatorias
Top New Installs=Top nuevas instalaciones
Top Trending Apps=Top tendencias
Spotlight Apps=Aplicaciones destacadas
All Apps=Todas las aplicaciones
Statistics=Estadísticas
Credits=Créditos
Support=Soporte
VERSION=VERSIÓN
Change Log=Notas de la versión
Debugging=Depuración

; Credits
Development=Desarrollo
Additional Contributions=Contribuciones Adicionales
GUI Layout Design=Diseño de la Interfaz Gráfica
Application Feed=Lista De Aplicaciones
Additional Testing=Pruebas Adicionales
Moderation=Moderación
Additional Libraries=Librerías Adicionales
Copyright=Copyright
Translation=Traducción

; Statistics page

unknown=desconocido
Last Change To Application Feed=Último cambio en la lista de aplicaciones
Docker Applications=Aplicaciones Docker
Plugin Applications=Plugins
Templates=Plantillas
Official Containers=Contenedores oficiales
Repositories=Repositorios
Private Docker Applications=Aplicaciones Docker privadas
Invalid Templates=Plantillas no válidas
Template Errors=Errores en plantillas
Blacklisted Apps=Aplicaciones en la lista negra
Incompatible Applications=Aplicaciones incompatibles
Deprecated Applications=Aplicaciones obsoletas
Moderation Entries=Entradas de moderación
Primary Server=Servidor principal
Backup Server=Servidor de reserva
Installs not allowed from this page=Instalaciones no permitidas desde esta página

; Statistics Popup
No invalid templates found=No se encontraron plantillas inválidas
These templates are invalid and the application they are referring to is unknown=Estas plantillas son inválidas y la aplicación a la que hacen referencia es desconocida
No templates were automatically fixed=No se corrigió automáticamente ninguna plantilla
All of these errors found have been fixed automatically=Los siguientes errores encontrados han sido corregidos automaticamente
Note that many of these errors can be avoided by following the directions=Tenga en cuenta que muchos de estos errores se pueden evitar si se siguen las instrucciones mostradas
HERE=AQUÍ
The following plugins have duplicated filenames and are not able to be installed simultaneously=Los siguientes plugins tienen nombres repetidos y no se pueden instalar simultáneamente.
The following docker applications refer to the same docker repository but may have subtle changes in the template to warrant this=Las siguientes aplicaciones Docker hacen referencia al mismo repositorio Docker, pero pueden tener cambios sutiles en la plantilla para que funcionen correctamente.
If any of these entries are incorrect then contact the moderators of CA to discuss=Si alguna de estas anotaciones es incorrecta, por favor, póngase en contacto con los moderadores de Community Applications (CA).
Global Repository Comments=Commentarios Globales por Repositorio
Applied to all applications=(Aplica a todas las aplicaciones)
Individual Application Moderation=Moderación Individual por Aplicación

; Misc
Community Applications Changelog=Registro de Cambios de Community Applications (CA)

Each month we highlight some of the amazing work from our community=Cada mes destacamos algunos de los increíbles trabajos de nuestra comunidad
Check out these newly added applications from our awesome community=Mostrar aplicaciones agregadas recientemente a nuestra increíble comunidad
Check out these up and coming apps=Echa un vistazo a estas aplicaciones emergentes
These apps have the highest percentage of new installs=Aplicaciones frecuentemente instaladas
An assortment of randomly chosen apps=Aplicaciones elegidas al azar
Featured Applications=Aplicaciones destacadas

; Categories try not to be excessively long This is displayed on the left of CA screen

Backup=Copias de Seguridad
Cloud=Nube
Crypto Currency=Criptomonedas
Downloaders=Gestores de Descargas
Drivers=Controladores
Game Servers=Servidores de Juegos
Home Automation=Automatización del Hogar
Media Applications=Apps Multimedia
Books=Libros
Music=Música
Photos=Fotos
Video=Vídeo
Other=Otros
Media Servers=Servidores Multimedia
Network Services=Servicios de Red
DNS=DNS
FTP=FTP
Management=Administración
Messenger=Mensajería
Proxy=Proxy
VOIP=VOIP
VPN=VPN
Web=Web
Privacy=Privacidad
Productivity=Productividad
Security=Seguridad
Spotlight=Destacar
Tools Utilities=Herramientas / Utilidades
System=Sistema
Themes=Temas
Utilities=Utilidades
Private Apps=Apps Privadas
Uncategorized=Sin Categorizar

; Categories displayed within a popup or on the card.  Where an entry exists after the "=" it is not translated, but rather how it should look
GameServers=ServidoresJuego
HomeAutomation=IoT
MediaApp=AppMultimedia
MediaAppBooks=AppMultimedia:Libros
MediaAppMusic=AppMultimedia:Música
MediaAppPhotos=AppMultimedia:Fotos
MediaAppVideo=AppMultimedia:Vídeo
MediaAppOther=AppMultimedia:Otros
MediaServer=ServidorMultimedia
MediaServerBooks=ServidorMulti:Libros
MediaServerMusic=ServidorMultimedia:Música
MediaServerPhotos=ServidorMultimedia:Fotos
MediaServerVideo=ServidorMultimedia:Vídeo
MediaServerOther=ServidorMultimedia:Otros
Network=Red
NetworkDNS=Red:DNS
NetworkFTP=Red:FTP
NetworkManagement=Red:Administración
NetworkProxy=Red:Proxy
NetworkVOIP=Red:VOIP
NetworkVPN=Red:VPN
NetworkPrivacy=Red:Privacidad
NetworkWeb=Red:Web
NetworkOther=Red:Otros
ToolsSystem=Herramientas:Sistema
ToolsThemes=Herramientas:Temas
ToolsUtilities=Herramientas:Utilidades
OtherUncategorized=Otros:SinCategorizar
and %s more=y %s más

; App Popup Related
This application template has been blacklisted=Esta plantilla está en la lista negra
This application template has been deprecated=Esta plantilla está considerada obsoleta
This application has additional requirements=Esta aplicación requiere unos requisitos adicionales
Additional Requirements=Requerimientos adicionales
Donate To Author=Donar al Autor
Donate To Maintainer=Donar al Mantenedor
CLOSE=CERRAR
Author=Autor
Maintainer=Mantenedor
DockerHub=DockerHub
Application Template=Plantilla de Aplicación
DockerHub Stars=Estrellas en DockerHub
Added to CA=Añadido a CA
Date Updated=Última Actualización
Current Version=Versión Actual
Min OS=Min. S.O.
Max OS=Max. S.O.
Total Downloads=Descargas Totales
Popularity=Popularidad
Licence=Licencia
Ranked #%s=Posición #%s
; as in Trending up or down arrow
Trending %s=Tendencia %s
; as in As of some date
As of %s=(A fecha de %s)
Play Video=Reproducir video
Play Video %s=Reproducir video %s
This application is not compatible with your version of Unraid=Esta aplicación no es compatible con su versión de Unraid
Another browser tab or device has updated the displayed templates Some actions are not available=Otra pestaña del navegador o dispositivo ha actualizado las plantillas mostradas. Algunas acciones no están disponibles.
WebUI=Interfaz Web
Reinstall=Reinstalar
Reinstall From Previous Apps=Reinstalación de aplicaciones instaladas previamente
Install=Instalar
Uninstall=Desinstalar
Project=Proyecto
Read Me First=Leer primero
Install another instance=Instalar otra instancia
Install Using The Templates Default Tag=Instalar Usando la Etiqueta de la Plantilla Por Defecto
Moderator Comments=Comentarios del Moderador:
Note not all authors keep up to date on change logs=Tenga en cuenta que no todos los autores actualizan el registro de cambios
Note not all maintainers keep up to date on change logs=Tenga en cuenta que no todos los mantenedores actualizan el registro de cambios
Last Update=Última actualización
Note All statistics are only gathered every 30 days=Nota: Todas las estadísticas se recogen sólo cada 30 días
;the following if using a space you MUST use nbsp but keep it down to one word if at all possible
Donate=Donar
Currently Installed Version=Versión&nbsp;Instalada&nbsp;Actualmente
Install The Update=Instalar&nbsp;la&nbsp;Actualización
; as in you have the latest version already installed
Latest Version=Última Versión
Multi Language Support=Soporte para Múltiples Idiomas
Support Forum=Foro de soporte
; as in more than 100000
More than %s=Más de %s
Remove from Previous Apps=Eliminar de las aplicaciones instaladas previamente
Remove=Eliminar
See All Apps=Mostrar todas las aplicaciones
Favourite=Favorito
Application Type=Tipo de aplicación

; Graphs
Trend Per Month=Tendencia Mensual
Downloads Per Month=Descargas Mensuales

; Multi install script
Installing docker applications %s=Instalando las aplicaciones Docker %s
Starting %s=Iniciando %s
%s failed to start You should install it by itself to fix the errors=La inicialización de %s ha fallado. Intente instalar la aplicación por separado para corregir los errores
Setting installed applications to autostart=Configurando las aplicaciones instaladas para que se inicien automáticamente
Docker Application Installation finished=La instalación de las aplicaciones Docker ha finalizado

; Application Cards
Actions=Opciones
Pending=Pendiente
This application is a driver plugin=Esta aplicación es un complemento del controlador
This is a language pack=Paquete de idiomas
This application is a docker container=Aplicación Docker
This application is a plugin=Aplicación plugin
This is a spotlight application=Aplicación destacada
This is your favourite repository=Repositorio favorito
This application is from your favourite repository=Aplicación en repositorio favorito
This application is pinned for later viewing=Anclada para ver más tarde
Private Application=Aplicación privada
Remove Application From List=Eliminar de la Lista de Aplicaciones
Check off to select multiple reinstalls=Marque para seleccionar múltiples reinstalaciones
Go to the plugin settings=Ir a los ajustes del plugin
Click to reinstall the application using default values=Haga clic para reinstalar la aplicación utilizando los valores por defecto
Click to edit the application values=Haga clic para editar los valores de la aplicación
Click to reinstall=Haga clic para reinstalar
Click to install=Haga clic para instalar
Click to go to the WebUI=Haga clic para ir a la interfaz web
This application template has been deprecated=Esta plantilla está considerada obsoleta
This application template has been blacklisted=Esta plantilla está en la lista negra
Click info to see the notes regarding this application=Haga clic en información para ver las notas sobre esta aplicación
This application has additional requirements=Esta aplicación requiere unos requisitos adicionales
BETA=BETA
INSTALLED=Instalado
OFFICIAL=Oficial
UPDATED=Actualización
This is an official container=Contenedor oficial
Digitally Signed=Firmado digitalmente
This container is digitally signed=Este contenedor está firmado digitalmente
Docker Hub=Docker Hub
NOTE You must visit the dockerHub page to gather the information required to install correctly=NOTA Debe visitar la página de dockerHub para obtener información necesaria para una instalación correcta
Show CA templates=Mostrar plantillas CA
Deprecated=Obsoleto
Incompatible=Incompatible
Blacklisted=En lista negra
Template Exists=Plantilla existente
Template already exists in Apps=La plantilla ya existe en las aplicaciones
; eg: LinuxServer Repository
%s Repository=%s repositorio
; eg: Squid's Repository
%s's Repository=%s's repositorio

Info=Info
Attention=Atención
Repository=Repositorio
Why we picked it=Por qué lo elegimos
Application Spotlight %s=Aplicación destacada %s
Unraid Staff=Personal de Unraid

; Page Navigation
Displaying %s - %s of %s=Mostrando %1$s - %2$s (de %3$s)

Updating Content=Actualizando Contenido
Language=Idioma
Switch to this language=Cambiar a este idioma
Country Code=Código de País
Install Language Pack=Instalar Paquete de Idioma
Remove Language Pack=Eliminar Paquete de Idioma
Update Language Pack=Actualizar Paquete de Idioma
Installed Version=Versión Instalada
A note about translations=Nota acerca de las traducciones
Click here to view the language changelog=Haga clic aquí para ver el registro de cambios de la traducción
View Missing Translations=Ver traducciones que faltan

; Update Checks
Check For Updates=Comprobar las actualizaciones.
Check for updates already running=Comprobar si hay actualizaciones en curso
Checking for docker container updates=Comprobación de las actualizaciones de los contenedores Docker
Checking for plugin updates=Comprobación de las actualizaciones de los plugins
Checking for language updates=Comprobación de las actualizaciones de los idiomas
Checking %s=Comprobación de %s

; dockerHub conversions
Determine configuration=Configuración determinada
Would you like CA to attempt to determine any applicable paths, ports, and variables for the template This will entail performing a test installation of the container It will be automatically deleted after processing The container will not be started=¿Quiere que CA intente determinar las rutas, puertos y variables aplicables para la plantilla? Esto implicará realizar una instalación de prueba del contenedor. Se eliminará automáticamente después del procesamiento. El contenedor no se iniciará.
An error occurred - Could not determine configuration=Error - No se puede determinar la configuración
; WebGui
Click Install to download and install the Community Applications plugin=Haga clic en **Instalar** para descargar e instalar el plugin **Community Applications**

